86,19
101,140
86,134
48,139
15,111
45,30
20,17
22,116
77,133
89,36
11011111111a1111111101111110111111011011001111101011110110111111110111111111111111111111001a111011201220221201021211202002001021111011011011a1111110111111111111
11111111011a1111111111001001011111001111010111111111101111111110010011101111111100011111001a111121100020221222010111011122222021111111100111a1111111111111111011
11011010111a0111111101011110101111111011011010110111110111101011011010111111111101101011111a111122221202011021021211212222121011110101111111a1100101111111111111
11010111111a0111010010111111111111111111111010101110010111110011111000101111111111101100111a111112122111122112102201201222112121111110101111a0111110111111111001
11111010111a1111111010110111111011111111111111111111111111111101111011101001111111100111110a111110001222201101022212212121112001111111111011a1111010111001110111
11222212210b1121220211121122112011101111110011111100111111110111111101111111111011011111111a110101120011122222211200110120111221111111111111a1111111001111111111
11122111001a2220211221121020101121010110101011111111111111111110111110110110111111111111011a111010022122022212211001102220121121111101011111a1010111110111101011
01110222022a1012111211100210201200101110101011010110001100111011100011101011111101110111110a111121212202220021222110222220102221102111111011a1001110111010111111
11022211222b1012101110211012111010101111010110111111111101111111100111101111111010111101111a110111112201122212210222222212211212201211111010a0111111111111111111
11110121221b1200022112101112201211111111111111111111111111110111111101010110101111101111111a111101111220102201222202211000120112112211000110a0110101010100010011
11010010212a0111222001210201122100111001111010111110111111111111111111111111011011101111101a100101101221121221122212202122022102211201111110a1111110111001100111
11001121120b0222221101222212211221111001111111111111111011011110111011110111111101010101110a110110112102102222222202201120222210120211011111a1111011101011011111
11022010100b1111002020212222202021111111111111011110110111111111111101011111111111110110111a110111010222210222220101120020102111021211111011a1001001111111110111
01112101112b2110220112021220121100111111111001101111101000111110111111111011111011111011110a011011011012202122222212220222222222210210011111a1110111100011111011
11211200011b2122211202201021121001101111111111101010111111111101010110100111111111010111111a110122121202212122022222002201122221111011111001a1111111111111101111
11111211112b2122111101112121111211111111111110111111111111111111111111111111101110110111101a111101111212210222022022202202120221202211111110a1111111111110111111
11212102111a1211120202112122201211111010011110010111111111111101111001110110101111111110111a111122112211122221122102222201002112012211111101a1111110111111111011
11202111121b1101012211110111210011111101111111110011010011011110110011111110111110111101101a111120122200021102221202222222210220221111101011a1111111111100101111
11200102211a2101111210221201111101101110001111011101111111111111001011001111101111110101111a011121011021220201122212222122212110221111111101a0110011111111111111
11211211222b0212212200122112121211111011101110111111011011110111111011111010101101110111010a111122221210021122220222221022222211112111001111a1111111111101111110
11112212121b0122022011221021100121011111111111001111101110110111100011111110001111011110111a110121210011222222212102212221220200021111111111a1101111111101110111
11201112110a2102112222022111212211111011111011111111111111011011011011111001110110110111111a111112011202121222212212202120220222212111001111a0101111111100101111
11111120222b1110201122101022212201011111111100110011000111111111111111110001101110111101111a111102022222022202212202222122120121110211111110a1111001010111111111
01022221102b2102112120110211111221111111110111111111111110111111111111111110110111111110111a011101002012121022111221112222212222211211111101a1110101111111111111
11211120220a2102112111121022221101101111111111011111111101000111111111111111101011101110111a100122221000202222222221100222000110122211111111a1010011011101111111
11111222102a2212221111122102210120100011101001011111011111111110111111111100111110111111111a101101121212220222220122221022122111221010111001a1111010101110101101
11200122111b2212010212221120100220110101111011101111110111001110111011011111111111111111111a110121120220220221222222200222112220122101011111a1111111111001011110
11222112120a1010122221212211212021111111111111010000111111010111110111111111110101111111111a001122110222022202122120002201202220221211111111a0110111111111110110
11111020120a0122001221011121011021111111110001110111111111101111110111111011111111110111101a110122212122212122020220102222212121212101111111a1111111111111111110
10222121121a1001122212212121212111011011001111111111111011111111101111011111111011001100011a011121201001201222002112021122020021202111100001a0110111110101110101
11122020201a0211212220222220022012222101102222111111101011101001111001011111011110011111100a011110021022222002001102200211220221211111001111a1101011111111111110
11120101122a1220121022211102201222120111021212111111111111111111111011111110011111010111011a111111111021012210201212211112012122121111001101a1111111101111110111
11122001000a2220122011221101202222212012022012110110111111111111101011011111111111010111101a110111011111202002022220012111222112212110101110a1111001011111110101
11222111211b1120222222122021222011120221001220010111111110111001101111111110111000111111111a001011011111122121002201221212121202212112101122a1111011212201111011
01201122222b1021222202212202022222021110211222111101101111111111010101100111111111011110101a010010111222111002012112211211222221122200011112a0101212211122011111
11202121100b0102222021202011120222220222222210111111110100111111111101111111111111101101111a101111101111210111200212122120122022202201100202a2211111210021111111
11110000011a1102222211001121122221112111021112111111101111101011111111111111111101110111111a111111111001011122211210002021212212210012111001a1111212110221211101
11111111101a1011022021121222112221111212002010011111100101111011010101101111111111010110111a011101100201111221211212011211012220122200121122a2102212111210100111
11101011111a1110021222021122121202210212202120101111101100111101111111101010111111111101111a111110111111111111111111111111112212212212120211b1121022111021001111
10111111111a1111020122201020011200000000110022111111111111111111011111111111010111111011101a111101111111111001111110101011111021211221111211a0112121111120111111
10111111010a1112201202012200011111221112211120101010111011111011110111100111010111101101111a011110111101101111111111111111101210211211021112b2121101222001011001
11111111111a1101112112222111120121110121111022111011111111111110111101111111111111110111111a111010111101101011111101110111112010212121020012a2222110221112211011
11011111111a1002012202210121100211102111111010111111110111111111011100111111110110110101111a101111101101101011111111111111112020211121211221a2101011112210011111
10111111111a1112110112201112110111010122201222111111101110011110111111111111111010111111110a111110111111111111011111011111112221212222012212b2121120210221210111
11011011111a1111221011021122111101121111111222111111001110101101111111101111110110111010111a111011000101111111110010101101110111110111220100a2111020101202201111
11111110111a1111120202201211212210011122110112011111101110111111111111010011111111111110111a111110111111101111111110000101101211202211122222a2211101111120011111
10111111110a1110022222101111111002210210012112011111111011101101111110101101101011001101101a101110111111011101101011001011112022212211121021b1112212211012011101
10001111111a1112121202122112211111112112112112101011011011110111111111111111011111111011111a111111001010000111011111101111102121212202012112a2212120112122211110
01101011111a0112110012122122122112102011212012010111110110111111101101111111101111111100111a011000101101011101111111111011111112001000112100b1120202010222211111
01110001011a1101220022201211212200102202212212100111111101111111111011110111111111110111110a111011111111110011110111111111111121221221120022a2111112022020111110
00110111111a1102220110012120011020112222111012111101001111111111111111111011111111111011111a101111111111111101011111111010101111222011212220a0210111101201110111
11111110110a1112020111220100102221222211020222111111111111111110111111011111101010111111110a111111111111011011111010110110012021011201110012a0022111012110010010
11011011111a0111222201201102022221211112122222111111111111010111111101101101111111001101101a111111111010101101111101111111002122212212222101a1121010201220211111
11111010110a1111201011222122012221212212012222111101111010111110101111011111101111111111111a111111111011111110111111011111011102211122110212a1212122122201111100
10111011111a0002212212112111101111222112221221011111111111011010111101101110101101111111101a011011000111111111011011110111111121222011200020b0100121121102111101
11101111110a1001001102122200102101210110022210111111111101011101111111101101011101101011001a011110101011100111100111111101012112202221111202b1011121111212211011
11110101111a1112221021211111112101001200100211000111011111111101111110001011101111101111111a010101111011111111111111111111111110201211120211a2012211011102201111
11101111110a1112220212212121211021102121021212111111010111101110011111111111111111101111111a111111111111111110111111011111111120111011120022b0101112121101211101
11101111111a0110202122211201221120122112111101101101111110101101111111111011111011101111011a111111111011111011110001111011111200222221001121b0112121210112211110
11111111111a1110221120102122111110110110110211111110111111111010110011111011100111110110111a111111111101111110011111110111011111021121210221b2012121212222111111
11011111111aaaabbaabbbbbbbaaababbbbbbbbabbababaaaaaaaaaaaaaaaaaaaaaaaaaaaaaaaaaaaaaaaaaaaaaa101011111111111111110111011001111112100122111121a2100012222111011111
10111111011011110011111111111111111101111111111000111111111010111101111010011111101111111101111101101111101101011110111111112111221121211120a2112022020202211111
10111111110111011110011011111111011111111111110110011110110111111101111111111111111111111111111011111110110111011111012112222222021022221222b2120222011210201111
11111100100111111111111110111101101111101111011111111101111110111110111111111110111111101111101110010111111111101001111022121221101222010222a2202222221021110111
00111101111100111101011111111101111111111111011111111111110111110111110111111111010001111111111011111111111111101011112120111121200020110112b2102110211111011111
11101111111111111011110111011111111111011010101111110110111011111110111111111111000101111111111101111011111100110101010111101120222201101220a2122101111110111101
11111111111111110101101011110111101101111110101111111111111111011100111101111100110111111011101111110111111111111110111222212220001210221211b1102100210110110110
11011111110111100111101111111111111111111111101101111101111110010101001111011110101110111011101110111101111111101111111111120011021110212102a1101110111110111111
11010100110111101011101011111110111001111111111101111111111111111011111111111110101011111111111111101111111100111111111210211211111210121012b1020010111101101111
10011110101110111011110011111111111111111010111111101101111101111101111111111101111011111111111011101011111011111110112222001000121221222100b2122121211101111111
11111111111111111111111110111011111111101111110010111111011111111101101011101111001011010111111111011111111011111011111102202111000220020221b1201120111111101111
11111111011110111110111111111111011010111111110100110101111111011101110011101111011011111111101111101111111111111111112222112012122222222202b0200210121111111111
01101111110111011101111111001011110111111111101101011011011101111111111111100110110001111111111111111011111110111111102222102022112202222221b2220222121101111101
11001110111110011110001111111001111111010111111111010110111111111111111011111101110111111100110011111110110111110011112110100202221202220122b0221120211010110111
11111111011111111110102101221221212122112121121112211111101111110111111111111110111011110111110101111000101101111111111221222222022000002222a2222211111111010111
10111101111011011011112221102122210011112122211221111111111111011101110111110111110101001111011011110111111111111101102220222220122112022022a0120122211101111111
10111111101010111111120212222111012212112122022122121011101111111011111100111111101101111111110110110111110101101111012212202222202212110210b2122222011100111111
00101101110111011111122202111121111122101221101222221110111110110111100111100111111111110111110111111110011001111111111212222101111010222100b1221222201111011111
10111101111111111111112100112212010212212112102112101000011111111111100110100111111111111011011111100010111111111111111222222220202220221001b2002212021111111111
aaaaaaaaaaaaaaaaaaaaabbabaaabbaabaabbbbabababbabbbabaaaaaaaaaaaaaaaaaaaaaaaaaaaaaaaaaaaaaaaaaaaaaaaaaaaaaaaaaaaaaaaaaabba2222222220202122211b2220021210011111111
111111111111111011111122210112212001121112220021212100110111110111110100101111111111111111111011111111111111111111100012b1222220222212222122b2200122221110011011
011111011111011111111210021112121211201111221110111211101011111110111111111111111111111111011111111111110111111111011120b2012012201112122022b1120222011111111111
111010001110111111110022101202022022121002211121020011111111111010011111101110111110011111111011111001111011111111111102b0022222100212022121b1210210121011111011
101111011111111111111111002112102122120112212221222111011111111111110101011011111011111111111111110110111011111110101122b0212222220222210200a2112000211111111111
011111101011011111111121222202101210121121111200112011111111111111101011111110111111111101111111011011110111101011110121b2002201221102002121b2222122111111010111
aaaaaaaaaaaaaaaaaaaaababbbabbbabbabbababa2202110220010111110001110011111101111111011111111111111111101001101110111111012b2222122220201210012b1222012021011111110
0101111101110101011111121212112020221221b1111110102011111101111111100111111101011011111111011111110111111110010111011111b2210121212220221222b1220212121110111110
1110011010011101011111212111210211211022a2212120110111101001110111100111101010101111111111110111110011101111111101111021b1222222202221221220b0022102121011011011
0011111111111111011110112112021101222211b0211222202111011110101101111011111101111011111101100101111110001110100110111120b2222121202222122202b1222002210111111111
0111111111011111111010110202000112101102b1122122221110101111101111111000111111111111110111111111111011001111101010111101b0022221222221121122b2222122021111111111
1111101000111111101111201200010120210110b0101201112011111111111111111101011111010110101111000101111111111101011111110122b2220202222202222222b2122222221111101011
1101110111011111011011222122002212222201a2122121001211111111111011111011110101111101111110111111011111110011011100111110b2222220120002222002b1121220221111110101
1111110111110111111001122222210211122111b2111202120211111110011111101111110111111111111111111110111011111101111110111002b2112211022212222111b2101121220011011111
1111001111111111101112222221012122122021a1022102222201011110110111111101011101111101111111001111011101111001111101111010b1221112011201110210b2221200211011111011
1111010111111101111011212010201212211220b2221211221210011111010011001111110011111111101111110111101001111100011001101102b2020110122112212012a2210000021111110111
1111111101111111110110120011212121021221b0111210201111111110111111111110111110001101111101011111011101111111110110111011a1111200002202212122b1210011201111111101
1111110001101110101112012201220011101221a1211221220011111111101110101111111011110111111001111010011111111111101101101011a2122112201222222011b1111012121111101101
0110111011111101111011111112122012211202a1011112021111110101111101111001111111011111011101110111110111111110111101110112b2221112022002202022b2201121100111110111
0110111111111011111111112120101200112022b0212121102011111111111101101111110111111111101111101111111101111011111010111110a1020110211221202222a2121221121001111111
1111011010111101111101120121222121220121a1111121211101111111111110011101011111111111110101110111111111111011001110011110abaaaabababaababbbbab2111012101011101111
1011111100111010101111001120212222101212a20122012221111101011011001101111111111101111011111111111101111101110011111110100011210122122220100220121122111111111111
1110111110011011111112201112122120210021b20110221120111011011111111111111101011111011111110111111100101111010110111111102222110002022122012022112222211111111110
1011011111111111101010112212111222120012a11211002211111011011111101111110011111111111110110111010001101111101111110111010111110101011111111111111001111111111110
1011011101101110111111122122010122000121a11221210112111011010111101111011101101101111111111111111100111111011111110011110111111111011111110101101001101001111111
0111111111111111110111221102211000112122b21221112212111101111111011111111111111111011101111011111111110110111111111111111111111111111011011111000110110111111111
aaaaaaaaaaaaaaaaaaaaaaaaaaaaaaaaaaaaaaaaa11111110111111111111110111101111111011110011111111110111011010011011111111111010101111011101010011111011111111101111110
1111010101111111111111111101111110111111111110111111111111011111010101110101011111001111010011111111111111111111110110111111111111111111001111110011111111111111
1111101111111110101110111011101101011111111101100111111011010111101111111111111110111111111110011101111110111011001111111111011111111111111111111111111111010101
0101111110111111111111011111111011101101111111111111110111111011101111111101111111111111111110111110100111111110110111111111111111111101010011110101101011111111
1011111111111011110101001111011111001111111111010111111111111111011101011111111111100111101111111111110100111111111111101011110111111111010111111101110101111111
1011110100100101111010111111101100101111010111111110101111111110111111011011111111111101011011111110111101111011110111111111111011110111011101111111101111111111
1101100111110011111110110111110101111010111111111011011111111101101101010011111111101111111111111001110111111101111111111011011111110010011011101111111110111010
aaaaaaaaaaaaaaaaaaaaaaaaaaaaaaaaaaaaaaaaaaaaaaaaaaaaaaaaaaaaaaaaaaaaaaaaaaaaaaaaaaaaaaaaaaaaaaaaaaaaaaaaaaaaaaaaaaaaaaaaaaaaaaaaaaaaaaaaaaaaaaaaaaaaaaaaaaaaaaaa
1111010011111101111111111101101011110111101111111111111101111011101111011101111011111101111110111111111111101111011111111111101111111111101111101111111101111111
1110101101111011110111111011100111111111111110110111011001110111111111111111111010111001101011100100111011111111111101111111111101101111101111101011010101101011
0001111101111111110000111111111101011101100111111111011110101111111101111111011110100110111100101111111111001111111111111110111111111110111110111111111111111111
1100111110111111111111111001111011101110110011001110111011111111111111110111101111111011111111101011101111111111111111111110111111101011111011011111111111101111
0111110111111010110111011110111000111111101111011111110011011111011111111111111010011111111111101001011101111001110011110111111111111111100111111111011101111110
1111110101111110001101111111110111101111111111101110010101101111111001111101101111111011011111111001011111111001111010010011111101001001111110111010111011101111
1101111101011111100111111111111111101111111111101111001010101101110111111101010111111011111101111101011111111101110111111110111110101111111110110110111111111111
