109,94
9,150
58,24
86,40
57,32
2,12
95,125
117,142
85,79
15,138
0201020021112202111211212102011111110111a10111111111100111111011001111110110011101101111101a1a1111111111111010111a1111111011011011201102212a11202111220211110111
1212211202111121111210212220111111101101a11110101101111101111111011111001110111111111111111a0a1111111111111111110a0111110100101221122220112a20100121022110110111
2222012112211121210122202201111011000111a11111111111111111100111010101111110111010111111111a1a1111010111011111111a1011110112212122212112222b21020122022011110011
1111112201002220120201221001111011111101a11010111111111111111001111111111011110111001111011a1a1111111101111110111a1110111112221112110011121a12121100011102110101
1122001211201100021211212020011111111111a11010101111110111100111110111011111101110101101110a1a1001100111011111110a1010101110222011221220121a22111102111021110111
1001122000202111111212102121111110111101a11101111111111110111001111111011011111111111100111a1a1110101111111111111a1001111112220122122212111b20121120111120111111
2221212210211122121121210211111011111011a11111111111111111111101110110111111111111111111110a1a0111111110011111010a1101111112110101112110101b02221212101212100111
2010121122012111122121002221111110101111a11111111011111111110111101101111101111111111101100a1a1111110111101101111a1111011011221110110112220b21112202102010111111
1102211010121220112212202101111111110011a01111010001011111110111011110100101101110110111111a1a1101111111111111110a1110011011222210210110222a02011111011002111100
2112101211101212022121201212001011011111a10111111111101111011111111111101111111111111101111a1a1011111111111101111a1111110112121111021011222b00112222222111111111
2122212112202012211100201102111111111111a11110111001110101011111100111111011001111111011101a1a1111111110001011110a0111111011222201201122002b12221221110210110111
2121222221021020021101101122101111110011a11110111101101011111111111111111111111111111111110a1a0111101111011111101a1101111102002221110011002b01020121101112111111
1222112121020122111222021112111111111101a11111111101101111010101101010100101111111110001111a1a1111111101011111110a1110001110212021212111111b20222111222201101111
1122221012120101222220111021111111111111a11111111110111101101101110110111011111110111111111a1a1100001010110111010a1111010111202201210211112a11211002111211011011
0121201110021112221110020210110111011111a11111111011011111111111110110111111011001111101111a0a1011111111111111111a1111111112222111220012112a12222221220122111110
2121200222220121211211111221111011111110a11101110011111011111111110011111111110111111011111a1a1101111111111111111a1011110111122021221222010b12210121110112111111
2011110202101212110122220222011101111011a11101111111101111111111111001111111111011001111111a1a1011011111110100011a1111111112222120121212020a01121221222002011111
1201112211111211122020122122011111111011a00111111011111111101111011111111110111111111011010a0a1111100111110110111a1101111111122010120220122b22212111202211011011
1011111111011111011101101111011111111110a11111101001101110101001111011111111111111110101111a1a0110010111111111100a1111101111112101210011121b10102120121102111111
1110110001110111111101110111110111011111a11010111111111011111101111101111111011011111111111a0a1100110111111110100a1111111111112002110211111a20222101100021111111
1111111111111011110111100110101111101100a11111101111110101101111110111011110101011111111111a1a1101111111111111011a1011100102222011212112202a00212202222112101111
0111111111111111011110001111111111111110a10111010111111101111111111111111000110111111111111a1a1111111111111110111a1111101102211022211212122a22222001112111111111
0110011110111110111110111011110001110011a10111111111101111111101110101110111111111110111111a1a1111101111101111111a1111111110201222112200200b01101211021010111110
1011111101100111010110101100111101111111a10111111111111110010111100011111101111111111111001a1a1111011110111001111a1000111111012120221121221a02110122222012111100
0111111110111110111111011111111101111001a11011111110111011101101111100111111111011111001110a1a1110111111111111111a1111111111012002111211210a12112112112021111111
0101111100101011001111101111110111111111a11111111111111111111111101111111101011111111111111a1a1101111011110001011a1110111111110112012010201b01120212020222011011
1111010110111101001101011111111110101001a11111111111100111111111110101111100111111111010111a1a1111111101111001111a1111101101101100221112110a11010110002121011111
1111110111110001111011111110111111101101a10101111011110111111011111110111111101111111001011a0a1111111101011011010a1111111111210122021010210b10122211121122111111
1111111111111111111111111011111011011101a11110101111110101111111111001110111101111111100101a1a1001111111111111011a0111110112201112121102110b02020112211022111111
1111111111101111110001111001001111001111a11111111101111111111011111111111011111111011101111a1a1011110011011010011a0011111012210122111122000b11112202201022111111
0101101101110111011111111111111011101111a10011111111101101101110001110111011111111111111101a1a1111101110001111110a0111111002110212211101222b20212211012201111100
1100111011110001110100100111011111011110a11111101111111011010111111011111111111111011111011a1a1011110111011010011a1010011111110111101101001a11111110111111100111
1011111111111101111111001110111111011111a11111111111111111111110110011110111111011111111110a1a1111111101111111110a1010101111111011111111111a10111111010111111111
1011011101111111111110111111110111111101a01011111111111111101100111100110011110111111111111a1a1111101111101111101a1111010011110011011011101a11100110110111001010
1111111110110111111111111011111101111111a00111011111101100101011111111111111111100110111111a1a1110110001110111111a1111110111110111111001111a11111110011111111111
1011000111111111111111111111101011011110a11101011111111111111111110111111111111111111111111a0a1111111111111011101a1111111111010111111011111a11110011111111011111
1101111011011111111111101010111111111111a01111111011111110111111011111111111111111110011011a1a1011111111010111011a0111101111110111101111111a10110001110101111111
1011111111101101111011011111111101111111a01111110101100101111111111010101111111111011011111a1a0011111001111111101a1111011110111001011111111a11111101111011101111
1111110111111111111111111111111100111111a11111111111011111001111111111111111110011110111011a0a1111011111111001111a1111110111011001101110100a11011110111111110101
1101111100111111111110110111111111100101a11111111011111011111011111111101111111111111000111a1a1011111111111111111a1111111101110111110110111a11101011011111111011
1101111110111111111101111111111011111111a11111110111011011011111011110011111110011111111110a1a1111111111111111011a1001111111111111100110111a00101111001001111100
1111111101111110111111011111111111110111a10111101101111101011110111011111111101110101111111a1a0111110111111011111a0111111111111110110101111a11111111011011110111
1111111111111111120212121121212222012121b02102111111110010111111111111101111111101110111111a1a0111111111111111011a1110111101111101101100111a11111101111110110101
0111111111021200022121221021212112202012b21110211111001110111111011111111111111011111101111a0a1101111111111111111a1111111101111101111111101a11111011111111111110
1111101112112101212222212212002121012212a21102101101011010001111111111101001111111111111110a1a1111111101111111011a0011101111001101111111111a11011010111101001011
1110111012122111122220110102220211001220a11122011111100110111111111111111101101111111111111a1a1011111011010111011a1010111111111011111110111a11111110101101100111
0111001112211110220020022220222222122122b12112221010111011110101111110101010111111111111101a0a1100111111111111111a1111111110001110111011011a01011001111111111111
1000111111221222122212222222202222222022a11021220011011111010101111100100111111111111011100a1a1111111111111111111a1101111011111011111111111a01111111011111111110
0111111102000121122202222111220222222212a21212111111011011111111111011111111011111011011111a1a1111111111011111111a1111110101111111100111111a11111011111001110110
1101011112011100222211212022202222220012a01102221101011111111111111010101101111011111101000a1a1011111101011111011a1011111011011110110011111a11101111111111111111
1110011112211021222002000122211220222022b01111221111110111111110011111101100111111111111101a0a1111111111111111111a1111111111111101101111111a01101111111011110110
1111101112002221102021222212221021210020a01222120111111111101111110111110111110111111101111a1a1011101111111111110a1111110111110110111111111a00101111111101110111
1110011011222112122122220022122200212112a11212121111111111101111001011101110101000111111111a1a1110111111011110111a1110110111111111111110111a11011111111110111111
1110111110012221200220220222221222202122a21211201111111111111111011100110111111111001101001a1a1111111111111111111a1111101111111111101111110a01111011101110111101
1100111101202111222222212220012222222011a01222121111110110110111111100111111100111101111111a1a1111101111011011111a1111001111111111100111111a01111011110111111011
1111101111022112120101022122020220121000a21212120111111111111111011111001101111111111111111a1a1111111101111111111a1011111111101011111011110a10111001101011101111
1100000112112211220101112222221222222202b12022121111111001111110111111011111111111101111111a1a1111101111111010111a1111011111111101011111111a10111111111110110101
1110101112121211120211212222122210020222a11101221111011110111110111111011111110101111100111a1a1111100111111111111a1111101101111110111111111a11111111111111111111
0111011111012112122102222222022201221220a20221111011111100001110111101011110110111111101111a1a1111111101111111011a0100111111111011111100101a11110110111110011110
1111101010021021112222222012222122221222b12101120111111111101111111111011111110101111011110a1a1101111111111011111a0100110110111110110111111a10111010011111110111
0111101111120210100121002212002221202212a22212021011110101111111110111110101111111111111100a1aaaaaaaaaaaaaaaaaaaaa1110111110110111111111111a11111011110011100100
1111111100222202222220011202211200021210b21220111110111011111111001010101110011111111010111a10110111111111101110111111111111111111111111110a11110011111111110101
1111101112020122121222021222011022012220b22012211111111011111101001111011111011111101011100a10111111111111111111011110101111111101111101111a11111111011111111111
1111111111222210120120021212212220122122a12100221011111111111111111111001110111101111011011a11111111100010111111101101001101111101110110111a11111101011110111111
1101111010110211111120220220220221012012b11200120111111010011111111111111111111000111110101a11111110010111111011111101111011111111111010010a00101111111110111111
1010111012212202021122022102020122220220b22012221100111111111111111011101010111011111111011a10111101001100111101111111111110011101111111011a11111111111101111111
1111111112221112102022220202212222211122a10211111011111111111101011101111111111111100111111a11111010110011111100111111101001111011111111110a10111111101111111111
1011111012221112202100220002202200002202b20220121111110101110110111111101100011111101110111a10101011111011111011110001110111111111101111111a10011111111111111111
1110001112212110112022202222222202222202b12212111111111111111111011111101111111100101101101a11101101111111111001111101111111111111111111111a11111111110110011111
1111110111100211200211222002000222221222b22220221011011011110100100111111111111111111110111a11110111010111111111111011011111110100111111111a11101110111111110111
1111011012221002010022200202222010220202a12121221110111111110110011221201210121222112220120b11100111111111111111101111111111111111111111100a11111111111110111111
1111111112121102121122122201202222221220b22121202102221211011101110001121101211110100101220a12010011111111010011111111101110010101011101101a01111111111110110011
1111111112220122112222002211201202222201b22222122211122011011111011111001110221122222221011b21211001101111110111101001111011011010111111111a10101111100111011111
0111011110121012121012102222222002212212b21201102210122201011111100212222111201222022221121b00011111101111111101011110110111111111111101111a11111111001111110111
1111111111111111011111111210121010102222a01112022112122201001111202102122211011121211202222a10210111110111100101111111111111111111110010111a11011011111111011111
1111111111111010111111111120120221122211b20211222222021211101011102212212222002221221222022b22201110011011101111111111111111111111111111111a01100111011111101111
1111011110100110111111111102221102120121b12001210111211211111001112212210212221212001011000b11211111111110111111111111101101111101110110111a11111101111111111011
1111111111101110111011101220111100110001a22201000210112110011011212212210120202212111211122a22111110111111011111101100111001111111111111111a11111111100101011111
1111111111111011111101010100001211012012b11111212122222111110111221222020021201000112112111b00101111111111110101111101101111111101111111011a10111101111111011111
1110111111111111101101111222212110220122a21111210120011001111011110211122221121112122210011b21201111110111111100110111111111111111110111101a11110111111111101111
0110111011010111111111101211121110001011a11122020221021111110111122122112112222011001222120b02000101111111111110121210222102222212101221210a21111111111011111110
1111111111101101111111111111112011222022a02012112111210211110111212120102120012211102012020b21110111111111011122112122112122202012102110211b21111111010111111011
1011111111111111011101111221112212101112b12222222222221110111011020212111211221221101220202b10111101111111111121021200121220120122112011220b21111111111111000011
1011111111111111011110011222112211002021a22111221201112210111111100121202022020211100212100a22111111011111001001120121022201111120112111201a01101101111111111010
1111110101110110111000111212020221211110a22101222211201211111111020112001212122112211112110a12011011011110101100202111222111122212111222122a21111111101101111101
1111010111111111111110111220000110202222b22201122021212211100111222212101010021122120122020a11111111101101111111122110121212020210120111122b21010111111101111011
1111111011111101111000111220222012111122a11221220111221111011111011111101212201101221121122b22210111101101111100211211222222111001212112001a11110111101111010011
1111110101011111110111001021111211220022a21112211112112201101111211211101212211121112121111a22110111011111011112122101122221021120122101212a21010111111110011111
aaaaaaaaaaaaaaaaaaaaaaaaaabbabaaababbaaab10111211121220111111111211121222220111212221101201a21210111111111111121101220111121120220212220222b01111101011111101010
1011100101110111110101110001222121111211102012220220211211110111221121122221210202111221120a22111111111101011001221222222100111102211022211a21111111110111011010
1111111111111110101111011011212000211212120210111102022211110111200222012201111222212211111b01110111110111111120101112111212112222222211012b11010100111110111100
1111011111110011111111111102101112122010202221122112222200011110101021120021010102222010212a22111011011111111120200002111212102011011002220b20011110111011111101
1110111011110111100100110121102112201110002111022222012011001111120122002201212011220222212a02010111111101111112021211021211210210021101202a11001011101111111101
1111101111001111110011110201100212200112000102012101212011101111011021102100212110222011001a12111001110001111111202211221101210011122112112a21111111111110111111
1010111101111110011101101221111210112021120122112202002111011101112022011021022211111121121b12111111111110111111200221221112222212212221120a21101111111111111101
0100110011111111011111111121222121202211022220012021101111111111220111201022121121221121112b21111111011100010010212211012122111212221212210a20110110111100111111
1111111111100110011111110001022222022111010122121020010211111111221110221200210021111211122a00211010111111100112202201221202211110112112111baaaaaaaaaaaaaaaaaaaa
1111011101111110111111111101212111112012210222021102011111111111002002211121002121122201221a12111111111011011121121010222122221110012011112121111111110111110111
1100011111111101011011110212010210111001220001012112201111111111201111100102122221221222210b22211111111111010122022121122220112121202102122120111111111101101110
1011001110111100111011111111110201101222120220201120101211111111211202101211212211202211121b12011111111111111110211212222012211201101121122220111111111111111011
11111111111111111110111111111110221202222022121120000112110011102202220babbabbbabbabaabbbbba12210111111111111011201211012222112011221011102221111111111111011111
10110111111101111111101112210122110222221101121110212112111111111111110a1001110101111111111110111011111010111022120111122212012122122221121221001101111111110111
11111111111111111111110011101111001111110011100111111111011101111111110a1110110111110111011111011111111111111122111212010220110120120212222212212022021121020110
11111110010011011111011110010111101111111111011111110111101111111110110a1111011111110010111110011111110111111111010101221210202222012212222011022020112202022111
10101100111111111101111110010111111011011111010010101111011111001111101a1111111100111011111111111110101111111100120111102222022212022122002121201022002200120011
11111111011111101111010110111111001111111111101111111011010001111110101a1111101111101111010110110001111111000020111012101011202222222121210012111211211102121011
10011001111001111101110011101111111111111111101111110110101111111111011a1111111100111110111111111111111111011121220221111211010002101222210220212201222200211210
11110011111111011111110111010011111011100111101011111111111101110111111a0001110100110101101111100111111101011121211020111001002202212122222222122212100122111211
11111110110110111111101110111101111111111111111111111101100011110110011a1111110111110111011001110001111111110122201002122012212002020220122201022212121122221211
11111101110111111111111111111111101111010110111101111110110101101101110a1111111101111101100111111111111111110121120011110220220100110022022222212212012222022011
11111110111101111011000111111101011010101011100111011111101111111011011a1001011010111010111011011110111111111111112221121111222221120202211222212001021101020211
11110110111101011110111111110111111011111111011111111111111111011110101a1111111111111101101111111101111011111111111111111101011122111222200211122211221112101211
10111011001111111111111011101011111011110011011111111111110101011100111a1010111111101111111101110111110111111011111011110110111112102111122202211220211102201201
10100001111111111111111111100010111111101111111101011101111110000011111a1110111111010111001111111101110101111101111101111111111201212221211102222121221221100110
11111111110111000111111011111100101101111111111011111111111111111111011a1101111111111111100111111101111111011111101011111111110212222121200222121122101222112010
11111110110111101111110101110111101101111101111111111110111111111111111a1111110101101111111011011111111011111111111100100110011220211112202221111210210020110010
11110001011111100001111111011111111100111111100011111111010111011101011a1111111111111111011111111011101010111111011111101101011011012020022211011222022212210211
11111110111011111011101111110011110111111101010011111101111111101111111a1111011111001101111111110011111011111111111111101111111011202221221020222211122221011201
10111111111111111100110111110111011101110110011101111111111111010011111a0111111011011100011111011100111111011111111110110111101222022211121121221222212111102011
10011101000011101111011111000111101111101001111101111111111011111111110a0110101111111010011010110110101101111110011110010110111222222112211200112112220211111111
