8,6
114,90
97,51
21,158
81,99
46,49
58,36
76,42
44,64
80,20
01111111111110011111111011111100101111111111110110111111111111101a011001111010111111011111011111111101111011111111101111101111a101001011110111111101111111111110
11110111011111111110111110111110110101111110111111111111111111110a110111111101000111111111011110111111111111111111100111111110a110110100111110011111111111110101
11111111110010111111111111111011110101111110101011111101111111101a011111011111111111111111111111011110110111011111111011111101a111111111101101101111101011111110
11111011111011011001110011111111010111110111111111111111111011111a111001111111010101101111111111111011111111110011111111111111a111010111101111111110111101111111
11110111111111111100010111111011111011001111101111001011110011111a111011111111011110111010110111111111101011101111111111110011a111111111110111111011111111111111
11011111111111110111011011110111111111111101111011111111111111011a110100011111111011111101111101111111110111011011111110011111a111101011110100110100101111111111
10111111111111111111011111101001111001111111111110011110111111111a111001111011111111111110111111111111101011100110111111111110a111101011111111101212210101112122
11100111111111111100111011110111001111111111111111111101110111111a111110111010110110110111011111100111110111111111011101001011a111101110111111121222122111112211
11110111111111111111111101101111101111111110011111111111011101111a111111111111111101111111111111110101101111101111110010111111a111011111100111112002221211100222
11111100111111101111110111111111111100111100111111110111111110111a101111110101111111110111111111111110110111101100001111111111a111111111111111112122022112220020
11111100111111101111011110111101111110010111101111110111111100111a010110111110111111101001011111111011011111111111011110110101a111011111101110112112122111120102
11010110111111111011111100111111011111001111111110111011101111111a101110111111110001111101111110111111110111111010111111111111a110011011100111122222122111210111
01111111111111011111111101101101111101111110111010111111111001111a111111111111111111111010111111111111111110101101011111111110a110010111100111100201122222022211
01111111110110110111111111110111011110111111101010111111111010111a011100101111111111111110011011111010101011111110111111111110a111011110111111102121122112020022
01011111111111111111111110111111111111111111010111111111011101111a111111011111011011111011101001111101111000101010111111111111a111111101111111110210021212120111
11111110001111110011100001001111111011111101111001111100111110111a111011110111001101111111111110111011111011111111111111111111a101101111111111022211220221202220
11110111111111111111111111101111111111111111111001111111111111111a111011010111111111111111101111110111101011111111111111100001a110111101111111011122221222122121
11111111111111111111111101111111110111111111110011111111111110111a111110100110011111111011011111011101101111011110111111111111a001011111001111122111100221121210
01111111110111111110110111110111111111011011111111101100110111111a011111011111111011111111111000111111111111111111110111111000a111111110111111111010012212122202
11010111101011111100011111011101111101111111111001000110111101111a111101110111111100111111010111111111100011111101110100111110a111101111000111122122121112212110
aaaaaaaaaaaaaaaaaaaaaaaaaaaaaaaaaaaaaaaaa111111111110111110111011a100101110111110111111011111110101111011011101111110111111111a101111011111111120022200111211102
1101011111111111110100111101111100111111a101011111011111111011111a101111111111101101011111111110011101001111100111111011101101a101101110111011122212221212211011
1010111111111111111111111101111111111101a110111101111111111111101a101111111111111111101110111101111111110111101111011111111011a101111111111010022111111112011210
1111000101101111111111111111111111111111a111111110111101110011011a111011111111011011111111111111011111011001111111111111110101a111101111011001001101212120200012
0111001111101100111110011111111111101101a111111111100101101111110a110100110011111111110110001011111111111010110111011111111111a101111111111101111221110222200112
1111111011111101011111011111001111110111a110110111110011111101111a011011011111111110111100011111111011111110111000110111011011a111101111111011112100120221122211
0110110011111101111111110110111110111111a111111111111111101111110a110111110111101111100110011111111111111111110101111101111111a110111010011110122102002222112001
1110111111111111011110001101011101111111a011111111111011101111111a011111011111111110100111011111111111011011111111111111111001a010011101111111112221112102110102
1011111111111111001011111100111111111101a011001111110111111011011a011111010011111111101111101111111111011110111101111111101111a111111110111111120202102222221221
1111111111111110111101111111101110111111a111110111122021222211121b102211102121121101101111111111110101111111011111111111111111a101111011101011012201212222102212
0111011111111111111111111011111001111111a010011111221102120200012a111122111121101111111110111110011101011111011111111101111111a111110111111111111211211122122222
1111111100111111111101011111111001121111a222220010222020212021222b111121210122001111111101111101010101001111111011100100101111a111000001110111121021220221211011
1111111111101011001011111111100111000120a010220110222202012012122a121101201112121111111111010111011111101110111111111111111011a101111111111101010101210112221122
1110000101101111111111111101111111022112b122211212221120122222020b211021211122011111111110001101111101101111111111101110111011a111011111110110110021122022121121
0111111111111111111101101011111111011120a202011112110221121221222a102222121221121111111110111011100111101110110101111111101110a111111011111111112221012212120120
0111111111111111011001111111110111221021b122001212201001222221021a102111221222201110111101111111111011101101010111111101110111a111011111101111112012122220002111
1011111110111111011111011111111111111211a202221012102220110221011b222220222022020011111101111101111111110111111111101111110011a111011010011011112111022222212120
1011111100111110100101110111110111110112b112122012212202202212122a011222122220211111111101101101111111110111110101111111111110a100110110111111101111111101110011
1011111010111011111111011110111111101122b110221220222200121112102a212020201221211101111111010111110101011111111110001100111110a111111111111111011111110110101111
1111110111111111110011011011110111212220a112220102002202211121121a011210022121211110111111110111111111110111101111101101101101a111111101111101101011101111100111
1111011111011101111110111111111111221212a212021122222221221220000bababbaaabbaabaaaaaaaaaaaaaaaaaaaaaaaaaaaaaaaaaaaaaaaaaaaaaaaa110111011111101011101011011011110
1111101011111111101110010111111111212111b121111112202201222011001bb111221012022baaaaaaaaaaaaaaaaaaaaaaaaaaaaaaaaaaaaaaaaaaaaaaaaaaaaaaaaaaaaaaaaaaaaaaaaaaaaaaaa
1111111011110111100111111111110011212122a002022211220122211222112ba111111202122b11111101111101111110011111101011101111111101111110111101110011001111111111011011
0111011111111111111111211221222111022222b221222200220211202112201bb122110110212a11111111111111010101111110100111111101100100100110011111010111110011111111000101
0111111010111011101110210112210112120221b222021112210202120002222aa112221221102a01101111111000101011111111101111111110000111111111111111110111111011111111111110
0111111101111111110110021210120211202202a121121222202222221122201bb120211210111a11101111101011010111111111111110111110111010111111011111111111111101011111010101
0110101111110111101112112201212112022002b221220222202020200012012ba111201220112a11111111111111010111111111101110111111111011111110111111101101110111111111111111
1111101011111111011101121022011210201221b212112212220222222222222aa210222222110a01111111001101011111111101111111111001111011100111110110001110101110110001011111
1101110110101011111111210112112121222210b222122202221202002012102bb111121222121a10101111111111111111011110111111111111101111101011111111010111110110111110111001
1110010110111111111012122222001211202212a022220112212122022221122ab012022221000a11111110101111111100111111011101110110110111101111111111011110001111001111111100
1111111100111010111112002122020202102222b212001212222222222202212bb112022221221a01110110110111101111101101011111011100110110111101111111111111111111001111101111
0111110011111101011012222222001101020121a212122110220222002201112ab120112112122a01111111101011111101111101110001100111111111111111111010111111111111011111111011
1111111011101011010101220010202211220221b222211210222221122212200ba112022211200a01010011111111101101011111111111110111111110111111111110100010001111011111110111
1111111101111111111110021212121111221220b221122220202022022212012ba012222120112a10111111101111111101111001111110100101111100101101011111111011111111111111111111
1111011110111110111112122022221110202002a202221210222021222110022bb211212201220a11111111101110101111101011011101111011111111111111111111101110111011111110111111
0111011111111111101111222212210111100221b211202222220212121200200ab022120202122b11011111111111111111111110111111101111101011111111110011011111010101101011111111
1111101011111011111112111222220121110021b202202220212022022222211aa212001212210b10111100001110111111111101011111111011111111110111111011111111111110011101001010
1101111111110111111112110212200122222220b022212222221221212220010ba110221200111b00111011111101111111000110111001110111111110101111011110111111111001111111011110
0011011101101010111102112220012222222122a222222212222222222112222bb222121001121a11111111111111001101111001001011101111111111100011111110010111011111011111110100
1101111110110110110111211012121212221022a110022222222202022222012aa012212122212a11111011111111010101111111111110111111111011111111111100111110010110111111110111
11101111111101111011abbbabbbbabbabbbbbbab020112002101120200120012aa010110111111a11111111110110111110111111110011011111111100111111111101111100111111111011111011
11111110110111111111a12120122122222222212220222222202122221110101aa001011011111aaaaaaaaaaaaaaaaaaaaaaaaaaaaaaaaaaaaaaaaaaaaaaaaaaaaaaaaaaaaaaaaaaaaaaaaaaaaaaaaa
11011001111111111001a22212122200020122220211122121221110221101011aa101011111111111110111011110111100110011111011111110111111011111001110111111101111101111011101
11101111011111111111a02220120022102220111221201210011210221101110aa111111010111110110011111110011111111011111110111111111011111101011111111111011101111101111110
11111110111111001110a02012221212212120222002012222202211211101111aa111101111111111111111111111111000111011011111111101001111110101110111111111111111110111111111
10110212011111021102a01021110220210222220222112120221211121101110aa111110111100100111110011111111111111011111111110010111111111111101001110110101101111111111111
11011211222100212022b22222022202222012210221122022222211200111110aa111111111110011102012120112121211221212012111112011111111011111111111110111111100011001110011
11111201122211012202a20222222222202221102222212221111022110111111aa111101111000111112111010112001121122100220200222111111111101001110101111111011111111111111001
11011221212010100112b22011222022022222020222222200221110221011111aa011101110111111002011122222021211120111212112212111101111011111011110011111011111111011111111
11110112122011211121b10222122022220222022222221201102210221011110aa011111010111111111122122210211201011220202212100111011011110001011101111111111110111111111111
11101022200101122112a22222102120202021022212220222112202221110101aa111111111111110012122101012222202212222111111212111111100111111111100111011111111111101110011
11110212112012210000a12021022220222102222222122020221022211001111aa011110111110100012110212122121001222121211122112111000101111101111011010111011111011110111111
11111120211120110001a12222221220222222221212002222222201210100110aa111111111101110110202202021120211101112201022020111100011111111100011010101011111100111111111
11111001112221112021b10021222022102222220022221221222211221010111aa111111111111011110111121221101222101111002022200001111111111111111111000111110111010111101111
10111001201212212211a20122202022222211011211101111121120101111111aa111111111111111112212211201212112122220110022210101100111111111011111110111111111111101101101
11110220211112002002a11212212022112222210201012110012211201111110aa011101110110111011221122201001212110221011221022111111111111111111111100111111101111111001111
11011001211211012221b11220120222012222001122220211200111200101110aa100101010011111112121001122211111211212012110120110011111111111011111111110111111001110111111
11111211121122201111b20212020112100211122222102220001012211110110aa111110111111101010202212222021121101210122202012111101011111110011111101111111011011111101111
11101010120112201120b10022122212121222111201201112211221121111101aa110010111011011111121120211222121111222102212220111111111110111111101111111011111101011100110
11111121212000202211a11211221122121222112112121210012102221111111aa110011010111110011021200102110121221111122021221111110111111011111101111111110001110111111111
11001021111100110222b10101022221022011222012221211011210121110110aa111111100111001101101002212112100212100011220212110101111110111001111110111111110101111111101
10011102202122010011a10002112012020221002222122111111022121011011aa011111000111111012122121110220121221022221212212010111001111111110101010011111010011110110111
11111011212102212010b01200222200122222200221222020222222212222122ab111111111001110112212010002101102121221211200112110111011010111111111111011111111111101001111
11011221010212111111a12002002211202222222202222212122022101211222bb011101111111101012121211120202211111110021211012111010111011111111100111111111111111011111111
11111212122221201200a11012021121221220022222222222202202122222210ab011110011111111112222212200202222122212101112201110011111010110111111111101111101100111011101
11111120210221121111b22222220122222212201222220202222102221122101ba111011000111111111122122212220101020121120021112011011110100101110001111011111111001111111111
11111221122212122211b11222111220220220220122112222102210212201222aa110111111000111112202210221111002121111212222111111110011011111111111101011111111110111111111
00111002121222202120a22020010222221221221222212102220201202012011bb011110011010011102110212110210110202202221120210100111011101111111011110111110111111111111111
01110220122111022211b02112112210222121100212022122122221002200202bb111010110111011111021011212201210111112212101101111110010111111111111011011111011110111111111
01111012212222221022a12121221121020222012222122202112122221220011ba111111011110111111222112102222220120112120222111111111111010111011101011111101110111101111111
11111002110211122100a22122211022222222111122122022020112202212222aa111111110011101011120022122211221221201221221122001111101111101110110111011111110011111111011
11111210002001011222a02221221222002202221120221220110221211012221ba111111110101101102122212102110120122010222012101111101110011111101111100111101111110111111111
11111120111121221111b11201122222221122122210212012112022102210212ba111111101111100111122111222110221220201102122221110111110111011011101110011110111111011101111
11000222211112102111b11220112200110121211111101221221222022112111ab111010111111010012120222101122211212221102111011111000101100111110111111111111111111110111100
11101102021121120121b22211221211200020112221221101112211021222101bb111010011111011102122212102112111211122121122212001101111101110110111111111111000110111100011
01011202202122121120b12001221111122011202100210202112211011210212ba101111011111101111122122222122210202101021102212111110001111110111101111101110011100111111111
11101110110011111111a11111111101111010112121211221102110222201101ba111111101111111012202202122120110220211220221002111101110111011011110111111110111111011111111
11111111111111111111a11111111111111111112201012001011121220221222aa111111011111111111111111111111111011011110111111111111111011111111111011110111101111111111111
10100011110111011110a10011100111111111111201012121211121012222212ab110110011111101111111110111111101010011101111110111101110010111111110111011111011111110111111
10111111111101111101a110111111111011112221022aaabaabaabbbbaaabbaaba101011011111110011111111111111101111111111111010111111011111111110111111011111111111111011111
10111111111010111111a110110111101111021121221a22121121122221222222a101111111111011100111001101110111101111110111111001110110111111110111011110011111011111111011
11111000111001111011a111111101111111121112211b10121221121121120021a110101111011111111111111111111010110111011011111011111101111011111100111011111110001111011111
11110111101100011100a111011101011111211201122a21220222222101200112a010111110101111101111111111001111101101110110111110111111111111111110111101111001101010111101
11111111101111100101a101110111110111220102222b12211110012222220122a111000111111111111111111111101111011111111111111110111110111111010111000111011110011011111110
11100011011110111111a111111011111111100111212b12212221122122211211a111001111110101111110110111111111101011111000111001011110110110111111111111111011111111111101
11101110111011101111a111011111111111122112222a21211122111022221210a111011111111111011111110101111111111111101110110110111111001101011110111110111100001110111111
11111100111111011111a111010111111011111012120a21112222111201200201b111110111001100111111011111011111111111011001111111011111111101111111110111101101111111011111
11111111000011111011a111010111110110012212011a22202121112121021102a111110111111001111110101111111110111111100011111110111101110101111111111111111110111111000010
10111111111111111011a111110110111111022212012a21122101221101212002a001111011011110111111111111111111101111001101010111111011111001000111110001011110011111100011
11101111101111101101a110110101111011221222102a22011112120211210211b001111111101111111111010101111111101111111011111111111101111110110111110111011110110101111101
00011111011111101101a101001111111111212012112a20220022212112111221b111101111111111101111111111101111111011111111111111101101111110111101111111110111111111110011
11111111010110101001a111111111110111212202101b01111201211112111211a110101011111111111101111111101111111110011111100010111011111111111011100111111101110111110111
11010111110110011111a111111101110111021111110a22211222100212112201a111111101110011111101111111110111111101110111110101111110111110111011111111110111111111111101
01111110110100011111a111110111111111111111011a11011111010110001101a110111111011111111111111111111011111011111101111111110101100101111111101111111110011111110111
10011111001001011111a111111111101010111001111a11111110111110010011a111100111101111011111111111111111110100111101010111111101111011111000110111110111111011000011
01111110001001101111a101011110111111110111011a01110111011111100101a111111111001111111011111010111001011011011111111111111111111111111111111111111101101100100101
11111111100101111010a101110111011111111100100a01011111011111011011a110111111110101100010111001101111111010111111111111111111101111111011111111110111111111011110
10111111111011010111a100101111000111011011111a11111111111111111111a111111011111111111111111111111111111111010110111011011111110110111111110111111110111111111010
11101111111111011110a001110011111110110111111a01101111111011110101a001001111111111111111111011100111111111011110011111110110111101011111111111110101011011111111
10001111111110111110a111110111111010111111101a11111110111111110111a100110001111111111011111010110111011111110111011110001111110110110110111111001100101111111111
