82,158
16,5
97,140
82,2
119,126
99,93
87,150
93,146
4,22
44,106
1111111110201221112122022122210022111110111011111111111111111011101111111111110101111111101110111111000101011101111111101101100111110110101111111101101110010111
1101111021222002211020210210121111222210111101100011101111111111101111111011111101111110110111101111100111111111111111110010111111111111111101111111101111111111
1111111120101122122222100120221222222110111011110111001111001011011111111010001111111111111101111011101111111111111111011111111011111111111111111111011001110110
1100110210102122212121211112221222111100111001111110111110111110101101101110111101011111010111001100111011110111000011110111111111010111111101111110111111111111
0011111112101222020020112122212110112110111111111111011111101110111111101111001111111111110111111111111111011111111111111111111001110111111100101110001111111111
1101111212012020122121200012111111000211101111111111100110101011101110111011111110110111001111111011111011101111011111110111101101111101011111101110111111110111
1111111122011111122220012222122012212011110010110011111011111110111111011100101110110100101111111111111110111111111011011100111111111111110001001110001111111101
0101101221101122220221222021202211212201111111111111100111111011111111111110111111111111011111011110101111111111111010111111111111011000110111011111011111111011
0111111212120012012222210212102120002201101101011110101101111111111111011111111111111111101111111111111111110100011000110100111011011111111011001101111101110111
0001111210121212121122221211122111221211111111111111111011110111111101111111111111101101111101111111111011101101010111111111111111110111111110111101110011011100
0111010022122111002210111110212202010211111100101110111010101101111111111110111111111111100101101111111111111101111110110011011101111111111111001111111110111101
1111110222001100002110112111221120202101111111111111011101011011111111111111101111111011101111111011011110110111111111111111111111111101111110111011111111111111
1111001202222121211020222212220122201110111111110011111111111111111110110111111111111110110111111011101111110011111110101010110001111001111111111010110111111111
0011111220222022112120111100210210122110111011111111111110111111111111101111111111011010111010111111111111011110111110110100110111111011111101111111111111111111
1111100001212222221010222112221112211211100111111111001011111111101111100011110101100111100111111111111111011111011111011110111111101101111111101110011101111110
1011111022220121022101102022222012112111111111111111110111101111111111111110101101111111111101010110111111111111110111111111111110111110110111111111110111101100
1011110122211011222211212220212221200111111111111010111111101011101111111110111111111011111111111111100111111111001101101101111111100111111111110111111111101111
1111111201021222221202201221221221101011111011010110100011001011111010111101001100011100111011111111111111101111101111101111111111101111110101111111101110111101
1010110201211211011222102011122222222111111101111111110110101111111111110110101111111101110111001111111101111111011111111011111101111111101111001011111001101011
aaaaaaabbbaaaababbbaabbaaabbabaabaabaaaaaaaaaaaaaaaaaaaaaaaaaaaaaaaaaaaaaaaaaaaaaaaaaaaaaaaaaaaaaaaaaaaaaaaaaaaaaaaaaaaaaaaaaaaaaaaaaaaaaaaaaaaaaaaaaaaaaaaaaaaa
0001101100111110110111111111111111111111101011111111111001111111011111110111111011111111110111111111111101001111011101101011110111111111110011101101111111101011
1011111110011001100110011111111111111111111111111111111111111110111111010111111111111011110111111101111111101111111110011111110111110110111011001011100111111110
1011111111011111111111100101011110111111101111111110111011101111011110110011111110111001111100011111111111011111111111101100111011110011111111101011111101111111
1111111110101011111110110100011111111011111100101100011111110111010110110010111011111111111111111111101101111011111111110111111111111111111111110101111110111100
0111101111010101111101011101101011101011011101101101001111111111111111111111011111101010111011011101101111101111111111101111111111111110011101101111010011111110
1111111111011101110011111011001111111111111111111111011110011011011111111100101111111111111110101111111001110111111011111111111110010110100110111111010101111110
1011011101101101111111111101110111111110011110011111110110111111001110111111111011111110111111111111011011101111100110011011111111011111111111101111111111111101
1011111001011101100111111111001011110100111110111111111111101111111111111111010111111111111111111011111101111111011111111011011111011110101101110110111110111011
0110111010111111111111101101111111110111111111111001010011101111111111111110111100110111111011110111101111111111111010111111101111111001010111011111100111110111
1111111111110111110111111111101110101110101111101111101111111010101101111011111111111111110021121120120220202122211211022211111001111111111101011011111111011011
1111111001010011111111110111100111111011011111111111111111111111111110011111111111110111111221221021211111111222120122212111011111111111110110010011111101110111
1110111011111100000111110111011000111111100011111111111111110100110110101011101111110111111022122111211122022011020021121210011111101111011111111111110111011001
1111111111111111011110010110001111111111010011111111111111111001101111111111101111010111111012210012122112222211212001210111111111010111111111111111101111111111
1111111101011101111101111110111101011100111111101111101101101011111111111111111111100001101201012110210201200002121101012210011110111111101111111111110111111111
1111101111111111110110000111010111111011011111111110011100111110101111111100111110111111111111011011221110112200001120110111010010111111011011111111110111111111
0011011111111010011111111111011111111011100101111111111010111111111111100010101111111101111021110220201211212010200210012010101111101011110100111101011111101110
1110111111111110111111011111111111111111000101101001011011110101010111011111101100110111111212222212011012210012211212211210111101010111101011111101101011111110
1011101100111111111011111101101111111101111010111111111110011111011111011111111110111111111121102022111220211122111211210111111101010111101101111111111011110101
1110111011111111010111110111011010100100011011111111110010111111101110110101101111011111111002221222111002100111010212222000011111111111101111111111111011111111
aaaaaaaaaaaaaaaaaaaaaaaaaaaaaaaaaaaaaaaaa11110111111111111111111111111111111110001111111111012211221020211022211112022221111101111101111011001110011010011101111
1101101111111111111111111111111110010111a10111111111111111111001101001111110111101110111011111222110012012211110120202211110110100011111110111111101101011101100
0111111111110111110111101111111111111101a11101111111111110111111010111111011100100011111111222020021220101112222112010221111111100111100111111111110111101111111
0110111101111011111011111101111111111100a11011010111111111101110101111011111011111111101011220221211021122222011120111102210110110001111101110011001111110111111
1111111111011111010011111111111111101011a0111011010111110010001111011110111100111111100111121120122220011012110212122021abaaaaaaaaaaaaaaaaaaaaaaaaaaaaaaaaaaaaaa
1101110111111111111111110111111111111111a1111111111101111111111010101011111011111010101111110012022212222121011222202121a111111111111111111111111111110100010101
1111101111111101111111111111111100100111a1111101111111100111111111111011111101111111111111102101102212221221012220101222a111111110011111111100111111101111001111
1111111100101001111101111100101111111110a1111101111110111101010101111111010111100110111011111022002222211012010122222102b111111111011111101111110011111111111110
0111111111011111111111111111111000111011a1110101111011101111101101111111111111111010111111101021002102001202222222201221a211111111111011111111111111111111100011
1110101111011111110111111111111111101011a0111111101110111001100111111011011111111111111111101021210011220212012021220222b211111111111111100111111111011110111111
1011111111110111111111110101111101111111a1110111001111111111111101111111110110111111000101112111211202110022111222102121a111111101111111011011111101111001111101
1111101111111111100101011110111111011111a1101111110111111100111111011011101111110111111011002122222211122211022121220121b111011011110111111111011101011110111111
1111110011111011111101111101111111111111a1111111011111010111111110000111110110111111111111122100121120110001020222212020b111011111111011111101111101111111110111
1101010011101010111101110101111011100111a1011111110111101101111111111100101111111110101111011221112221102010121120022100a211011111111111111110101111011111010111
1010111111101111011111111111000111111011a1111111011111101110110100111111111111111111101111120111222222122121200222010122b101111111011111111111100110110110111011
1111111111101101111011111111010111111111a1111011110111111111110101110111110011110111011111101202111000222121211112021021b111111111101111111111001101110011110101
1110111111001111111101111110101101011001a1010111111101101111111010011111011111101101111111121122211111001011111020202122a111111111111111111101111111100110111111
1111111011111111100101111001111111111101a1011111110110110111111110011111110110011111111111000112112210210221210202202121b111110011111111111111111101110111111111
0011111111111111110010111111010110111111a1110111111111111101110101101111111111110111111100011111111222121011121102212111a210000111111111110011111000111011010111
0111011111111111010111101100111111111011a1111110111111101111101011111111110011111101011111111100100220212012121111221122b111111110111110011101001111011011101101
1111111111111111110111110111110111111111a1111110010111011111110111111111111111111111110111100122212020221121201121122222a211011110011011111101111110101111111111
0111110001111111111011111100111111101101a1101011111110110111111111111111111011011111111110111101111111011011111111101010a011011111111111111110101111110110111111
1111011010111100111011111111111010011011a1101010010111111111110111111111110111001001111101011011110111111111011111101111a010101100111101111000111111011111110111
1111011101111010110111111101011101110111a1110011110111110101111111011011110111111111111101011100001001110001111111111111a101101111100111111100111111010111011101
1111110111111111111111111111101101101111a011111111100111111111111111111110011110aaaaaaaaaaaaaaaaaaaaaaaaaaaaaaaaaaaaaaaaa110111111110011111100110100011111110111
0001111101111011111110111100110111111110a011111111010111111111110110111011101111a1111111111111011000011101110011011101111111011111110111111110101101111111011011
0111111111011111101111001110111111111011a010110011111111111011110011011111111110a1111101110111010111111111110110111100101111111111111110111111010111110101111111
1111011110111101111111010101011111111111a011011011111111111111011011111111111111a0111011101111111010111001111111101110111111011111111111101001111111111111110111
2121221022101210100100011011010011110111a111111111111111111111111111111111110111a1011111110111111111111111101111101111111111111111011111111110111110111111111011
1100121001210011211011111111111101111110a111101101111111101111101111111111111111a1111111111011011111111101110110110011111011111110010111101011111111011110111111
0110222122020212121111111111110010111111a110111100110011111001101101111111111101a1101111111111111011111011110110111111101111111011001010111011110111110111111111
1222102110112220111111110111011011001110a111011111110111011111011111010110010111a0110011010011111111110110101110110100011111111010111110111111010111111111111111
1220221211221001011001111011011111101110a111111111111111111011111111111111111101a1111111111111011111111110111101101110101111011111111111101111111111111011111011
0121101020121121121111010111111111111101a111111111111111101011111111110111011011a1111111111010101011000110101110111110111110111101100112012212022101120200200112
1022201002212122101111010011101111111111a001111111111011111011111111111010011111a1111111101111111111111110110111111110101111110111001111210121211012112011112212
2202110221101221111001111111101011110111a111111011111111111111111001011100011101a1111111010111101110111111000111110111111111001111101112222212212211020112212212
0201212101000221211111110110010111111111a111011011111110101111111101111111011111a1111111111010110101111111111101100011111110110111101111112121111212222222211011
0212212210211201110110111101111111110111a111000111110101101111101111111111111111a1101101101111111111111111111100111111111101111111111012121122211010020210121222
2120101020211121021111101011111111101111a101111111011111011110011011111111111111a0111111111111111011101111101011111011111111111111101111000211111111122102102111
1222101101211222121110111101111111110111a111111111111111111010111111111111001101a1100111111111111110111111111010100111011111101111110022221222011222022022101111
babbbababababbaabbaaaaaaaaaaaaaaaaaaaaaaa111101111111111111111101101011101010111a1111011111111101111111111111111111111110101111011112102110111222200222222220220
01222100122222221210111011001101111111101111110111111101111111111110111101111110a1101111110111010101111110011101111111101111111111022201121002221021120212221022
12201112111202101111111111111011001011010011011000111011111011111111111111111111a1110110011101111111111110101111011111110111111011112112021122110021122210011220
20210211212111221111110111011111100101111111111100111111111101111110011110111101a1101111111111111111001011111101011110111111122221021222222212112200220122222212
aaababaabbabbaabbaaaaaaaaaaaaaaaaaaaaaaaaaaaaaaaaaaaaaaaaaaaaaaaaaaaaaaaaaaaaaaaa1011001111111111111111011111111111101111110101120102022121221122220200202221122
2200112211022011211011101111110111111111011101010011111111111110111111111110011202102221220101011120121221200111110110111010112010122222202222222222220222222222
1222112111211002221111101101110101001101111111110011111111101111111110111011112112101121202210111210020122012111111111111111110212111222202222222221222222221012
1201221212111221221111111111111111011111111101110110110111111110101011111110001210221110122012120202012111111111111111111111112222122102021212222202202201112221
2102211022021222220011101110111111010011111111001101111110111111111110111111002221122100101211121012211222221111111011100011122111202220021222122220200220200222
221202012211112101110110101101111010100aaaaaaaaaaaaaaaaaaaaaaaaaaaaaaaaaaaaaaaaaababbbababbbbbaabbbabbababbbaaaaaaaaaaaaaaaaaabaaabbbbbbbbbb02212222100012222002
101012211112002111001011110111101111110a111110111010111111111111111110111110110120022211212110211211121112021110101011101111122121022202201b02220220222222122201
022020111221020121111011111111111111010a101111111101111001111111111111110011110211020022102210011211021021100101111011010111101222212110022b22220221222220222021
122222201101220211111110110101111111110a011111101111111110101111011111111110101212121222112122221002220101102111011111111100111120212220221b00112222201222201220
212212102111112110011111110011101111111a101101111111101011111110111111011111111122101210222122220122120221121111111111111111102020122120221b20222222220122222000
212212211100011210110101110011111111101a110111001111111111111111101111111110112211121100112122011000020102012011111011100101112212220220200b22222212022222202222
112112122110011221111011110111101101111a111101101111111010101101110110111111110111122012011200212212121112122010011011001111120212122222220a20222222202022022222
111112211011211111011101011011111001111a111111111111011101110011111011110111111102011202222122221221101110021010111111111111122212122202222b22202022202020022211
200110101112212212111110111100111011011a011111011111111110111111111101111100112201212112121110100011211210020101100111101111020112021222220b21200222220222221222
212102122002211021100111111001110111111a110001011101111111110111111011111110002222120020211212111212101210111111101111111101110220122212222b22222222222112220220
111011111111111010110110011111110101101a100111010111111101111111111101010111111221221211110121122221110111200100101110111101121221212212222b22212222222222002222
110101111111101011101011011100111111111a110111111011111111111111101111111111110221211201111100221100111122221010111011011111012121221010202b22220202022212210121
111101101011111011011111111111110110111a111111101011111001110110111111101110111101212201221112202221211002220111011110011101102011211202202b22122200022122202002
101101010101111001110111100111010011011a111111111111111010101101100100111111112112112101112122110221101212102111111111111111110002122220121b20122222222222221212
101101110110111111110011011111101001111a111100111011110111111111111101111011100011211222022022120112202211120011110111111111122220021210022b00220122122202022222
111100110111101110110111111001111111111a111110111101110110001111011111111011112110200212212101202221202221111111111110111111120020122212202b12222220002122122112
111001111110101111111111011110111110111a111111101111111010110101111111111111110210111012011221222201122222101111021111001122122012020220202b20222222202022211012
111111111111111111101111011111111111111a110111001101111111111111001110111100000201222221211210211212221201021012212211211020022222222022222b12222212222122122221
111111111100111011111010100110101111111a011111101110000111111111001101111111110120220022121221022010120212111112212122200012102222222220122b01221122212020222221
011011101111110111111110111110111111111a101111111111110011111111101111111111111022221100121201220122110122122112111210211120122200221212210b21120222111122222001
011110111011101111011101101111111110111a111001110011110111111111111111111101111220221222122121221022122112012010222221120112020022121220220bbbbababbabbbbbbbbbaa
111111111011101011011111111011111110011a001111111111111111111111110110110111012202001220102212220022221112112112122121211122121122221122102202222021112001221101
111111111011110111101111111111011111010a001011101111111111111111111101111111111200011211122222100122210122020110121111110021002002212220120022022011211222220111
100111111101111111111111011111111111111a111111101111111001111111101111111111111120120221100010121101022212021110222012121111112122222222222112121110120122011011
011110111111110111001111111111111111111a101110011010111111110111111111111001111111120221211112120212211022212112220021222100222012222211122202011021112212021100
110111011111111111110101111100111111110a110011111111111011111011111111110110111212121222222211010111222110100111110012111011001121101112212022111111011111011101
110011111111111111011111111111111111110a111111010011101111111011111111101100101221112111012222101120200120012112202122122222212111002202012101011111001110011110
110111111111111101011111111111111110011a111111111111011101011011111110111110111111111111111010110111111101111111222100111011210121101102122111100110111001111110
011110111111011110010111111111111111111a010011011011111011111111011100110111011011110010110100110111111101111012120201112112011121211011112102110011111101111011
111111111111111101111110101100111111011a101011111111101100101101011011111111111111110111010011111101111111111111112210211101202021220120110111111111111111011111
111010010110111101011000011111110010111a110110111111111110110111011110110110111111111001111101101101111111111010102202102002212112212221211121110111111101111111
111011111111110110110011101110111110011a111111111110111110110111011110101101100110101110011110011111011111011111112122022111121012212102220010111111111110111111
