17,75
119,125
109,146
14,67
37,148
54,127
42,122
37,64
87,25
87,131
1111111111111111111111011011110110011101001111111101111222201022021100a02212122122211001111111111101111101101111111111111111101111111111111010111111111101111111
0011101110111010101111101111101111111111111111111011211211000200021101a20222112002001111101100110101011011101111111011011101111111110111111111011111110111110101
1110101011111111111110011110111011111111111101001110201101000122020221a21222111112210111101111111111110111111111111111111111101110011111111111101111101101101101
1111111110111111111101111111010101011010000111110111101111202222212221b02220211012111111111101111011111011111111011110011111111111110111101111111111111111101101
0011111011101101110011011111110111111110111110001111111101122011122112a22211120211210111111100111111110111101111110110101111111110101101111111111110111111111111
1111111111011100011111101111111111101101101011111111221112212221210211a22112120102111110100111111011110111111011111110011110111111011111101111111111111110111111
1111011101111101111111111111111111110111111111011110120021212012121010b21212011020211110111111011110011111111111111111111011011111110010101011111111011110111111
1111011111101011111111001101111001011111111101011111101212112211120212b01001111121111111111111111101111101011110110111101101111101111101110111111111101111001111
0111111111111011111111111011111101111111111101111011211221110012112222a22110121212111111111111101011111111111111111111111110101100111010111111111111111011111110
1111011011100110111110111111111111111111111011111111212101121102112111b21111011122211111101110111010111111111111011001111110111110110111111111111111001011101111
1011111000111111000110111111101011111111111111110011121002221111011112b02202111210211111101011111001110111111110111101110011111110111111101111011111011111111100
1111111101110111111111111100001111111001111101111111220021122110222021a11100120220110110111011111100111101111010011111011111101001111111111111111010011011111111
0100111110011110101111111110011111111100111111111111111020120102122112a01120011110110011111111111111110101110111111111110111101010011111011101101101011011111111
1111111111111110111110111111110111111100111111111111021010022212202112b21220200122211100111111111110100101101011110111101011111111111101101111011111011111110111
1011101111110111111111111111100110011111110011111110111121121121221111b22010112211211111010111101101111001101111111111111110011111111101111111110111110111101101
1111111111001111111011111101111101110000111110111111102011120122212122b00111210222100111111101011111101011101100100111111111100110100111110101111111110111111011
1111111011100111111100111111111110011111101110111011011200202122021002a02111112111210110111101111001111111111111111111011011111101001110111111111011111111011101
1001111111000111111110010101111111111101111011101011121222111210120100a22121112222200110111111111111101110101111101101111100110111101111111111110110111111101111
1100111011111111110111111111011111111111111101001101111101100221102121a12001202110011111001101111110010111110011101111111101111011111111101011100101111111111001
1111111101100001011111101111101111110111111111111110001212001111010122a11111120111210100111111001011111011101111111111111111111111001111100101111111011111111111
1110110111111100100111111101111101101011011111000111111102111222112120a21011112200210110101010100110111101110111101011111111101100111100101011111111101111100111
1110011011101111011111111101101110010011111111111111201221110222121011a11212220202211011101110011011111111111111111111101101101111110101011111101101111110111101
1111100111111101111111101111111110111011110111111212220012222202222012a02222202210110111110001111111111111100111110100111111110111111220121101202122022202011002
1011011110111111110111110111111101101101101111100200202010020222122222b21222222210201110101111111111111011111101111101101101101110110001011201002221210112121102
1111111011111011111011111111011111111111111111011110022122222122212222b02110221122011111011010111111111111111111011101100011111111111112010122221200222221221112
1111111101101111111111111111111111111111110101111121222201220221222210b12212202121111110111111111111010111111111111111111011110111111221110121111011112101122122
1101111010101110110111101111111111111111111101111221212122122022210220b12202120102200101110101100101011011111111111111101111111101111220001111212120102210212002
1111111111111111011101111111111111101111111111111202222221002202221120b22222021111111110111111111110110111122221211201121001222200112022212110101012120122122221
1111101110101101101011111111111111110111101110111012201211201121222102b22220220101211111111111111111101111121000121101212112121122210212121211222002101021211221
1111111110101110111011111101101010111100011111001122120221222201222201b01222012221111111111111110111101111121002121002112220111001222220222121220221210211212221
1011110110111111011111011111111111011111111110001221120212121210212121b02111011111110110110111111111101011122112000111010210111211110212110211102222212212102201
0011011111110111111110111111101011111011111111101022211002222210221111b12122221111100111011111111011011111110211020021001101212222122022121112020122210111110121
1101111111111011011111111111011111111111100111111221111122222122112101a21212112210101111111110110110010111121012221011021222101001112121201111101111212122021221
1111110100101111111001111100111111100101111111011221021120021111212212a20001210111111111111011101111101110111110021121121211222212221121210112120222111111110112
1111111011111111110101111100001111111111010111011110112122210021101120b20222201111111110011011011110110111102112220001211011020102110212202022200012110211222021
1101111111111111110111111111111101111011101111010122212201102111222111b11221201111110111110111101111111111012221212011222221221121201020202101202120221220201112
1110111110111111111111111101100110111111111111111122221112112111112110a22111121211011101111111011111111111111112211122101210201222112000021201220110211210101211
0111110111111110001111100111111111010011110101111211121110111221102111b22212212011110000110101011110111101101010111211011221222111100122121210122221202112222002
1111110101110111110111110111111111111111011111111221122112222110102111a1112021111111111111111111111aaaaaaaababaaaabbaaaa1212120112212212021102212021221221210102
1111011011011011111111110111101111111111110100101112121211112220101222a0210000210100111111001011111a1110010222120222002b0211222122021222222222021111120012201211
1111111110111011110111111111110110010001111111001121112102120111112012a0121102221111001111110111111a1111101121120122212b2022220122022221121122222202012012111120
1111111010111001111101110111011111101101111110111120112101012022122120b2212102121111111111111011111a1011111211210202222b2122022220202220020221100202222210101002
aaaaaaaaaaaaaaaaaaaaa1110110111101011110011111100222112122111221220222b2110121001101111111000111110a1000111001120220122b2120220222200222021222121101021112220022
11111110110111111010a1011011110110111111111110011112111000121221210212a1101122211111110011011011111a1111111111201022222b2221220112220222102222221022102220111222
10111000110111011001a1111111110111011010011001111122222122221121012122a2101221111100111111110111011a0111111220212220121b2100002222221122222202122202011200122210
10111111010111111111a1101111101111001111111110011201212111111121120102b2212110201111111111111111111a1111111201112121022a2022021221221022021212201200122211121202
11011111011101111111a1011011101111011111101111110202022110021012002120a1200211211011101111111111110a1000111111011012201a1200212102210222222122001121122021200222
11110101110111111011a1111111111111111111111011111101210212211110212102b1121212201011111101111111110a0111111121212121020b2222200122201012220010222210120212012221
11111011011111111111a0101111100101101111111111110211010002202221212102a2122122120111111111111111011a1110100222012211000b0220212222122222002202121211122211020221
11011100011111111011a0111011101011011111111111111210222200221020112211b1122221111011001111101100011a1111111101112222222b2022011221001220222221221000121022201212
11101111111111001101a1111111111111110111101011101112112101122210011222b2211111121110101101111110111a1111101121121212221a2021222222112212122112221011021121110022
01111011111111011011a1110111011111101011110011111112110100021112112222a1121102221110110111011110111a1101011122202221221b0002221010211222220222212112122102112012
10111111110111110011a1111101101011111111010001111020022012102110112122a1102112110111111011111111111a1111011111202222222b2022022222221102221201212021211001221101
11111101111111011111a0111111010111111111101111110111101110101111101010a0111110011110101111111000101a1111101221111222102b2020222212202222122111011111101110111101
11111111111111101111a1111110111011110011110110101111111111111111101110a1101111111011111111111101101a1011111212011202211a1021112200221222222211101101010111011101
11111111111111101011a1111111110111011111110011111111101101111011100111a1111110111010011011110110111a1001111222112220222b1222210121002222020121110111111110101111
11011111001110111101a1110111111011001111111111111111110111101101111110a0111111111101101111000111010a1111111210021200112b1122121022102202201121110111110111110111
01111101101111111111a0011111110111010111111111111111111110111101111111a1111111110110111010111100111a1111111111212002222b1220021222222220201002101101101010011100
11101110101011110101a1111111111111111111111110111111101111011011111111a11111111aaaaaaaaaaaaaaaaaaaaa1101111111010012020aababababaaaaababbaaaaaaaaaaaaaaaaaaaaaaa
11010101101110101011a1111111110111111011010111110111111111111111011011a11111111a11111110101110111111111110110111222002112112211110210011122200111111110011110111
11110111110111111111a1111110111111011101111110111111111101011001111011a01100111a10111011111111110011111110101111202201220201220102112122122201210111111011111111
11111111111111111111a1111111110111111111110010111011011111111100111111a11111111a11111111101111111101011110111011222022221020112011101121220122201111111111111101
11111111111111111011a1111110111111101010111011101111011111111111110111a11111111a111101101111011011010101011011112222012abbbbbbaabaabbabbabbababaaaaaaaaaaaaaaaaa
11111111111111101111a1111111001101111101101111101111111101011110111111a11010111a101111110111111111111111101111101101101b2022220201112010212112111111111111110111
11110110011010011110a1111110011101111111101111111101101111111111111101a11111111a111111101011100000111101100110111110022a2212221120221212011210001101001011110111
01111111101001111111a1111100111101101111111111111010111111111001101110a11111111a111111010111101011110111111111111002110a2211102102022212211102101011111100111111
10111110110011111111a1111101101111110111011111011111111111111111111101a11010110a101110111111010111110111111011112222022a1021110120021220120101100111111101111110
01110111111011011101a0111111101111111101111101111111110111111011111111a11111101a010111111101011111011111111111111021211b2111110212022122112111111111111111111111
10111110111101111110a1111101111111111101011111100111101101011111111111a11111111a111001011111111111111111110001012121221a1121212011101022102021011010111101000111
10111101111011111010a1111111111110101011101111110111111111111111111111a11111011a111111111011111001111111111100011111212b1222200112012020211122211111111110110111
01111011111011100111a0111111111111011111111101011111110011111111111111a11101010a111011001111101111011111111111111101111a0011111101111110111111110111100111111111
01111111011011110111a0111111111111110011110111010001111101110111111111a11110011a011001111111010111101011111111110111111a1101110111001111011111111111111101110011
10111100111211112212a2201221111110112211111111111111111111111011111111a11111111a011110101110111111110011111101111110111a1220100222100111201212110211111101111111
01111111110112121202b0201211120121112002100111111110111011111001111111a11111111a010111111001111010111111111111111111211a0212222211220212101011212211111111101110
11110111012212210211b2120020202211222111011111111110101111111111100111a00101011a111110101101111111111110111011111111122a1222221101221022102210112221111110111111
11111111111101122111a2110222220011022011101111111110111111111111101111a10111111a111111111111101111010111111011101100102a2111102012122020221121201221111111100111
11111101012222102220b1010201011121112212211111110101101001100110111111a11111111a101111111111000110011111111111111101111a2212210101121222111111202221110111100111
11111110111122221122a2210022212121210122101111101101101111011010110011a11100111a110111111100111111111100111111000011210a2012122201112202011221220121111111111110
01111011112021201221b1211021221012201010111110111111111001111111111111a11101001a101110001011101110111101111111011110122a2201210112112221102012012011111111111101
11111011111021222210a2110001120112222112211011110111011111111111111111a10011011a111111101111111101111111111111100111220a0110112021202120011212211120111011101110
11110101110221222212b1110211111122112011001001111110101011111111011101a01011111a111111111111111111111011111111111111110a2121212112121012022212111011111111111010
11101110112210102102b0122101112022202202210111111101011111111111110111a01111111a111111011001111111111101111111111011111b1210221201102200211202221101011111110111
01101101110211222220b1222111212012021202011010111011111111101111011111a11111000a111111111111111101101100110011101110010b1201021102201211121202011121111111111101
11111111111001211012b1111200211101112212211011001101111111111111101100a11010111a111111111111011100111001111111001110202b2022110111211212101022220221111111111101
01110101110212122022b0220112002101001021201111111011111111111111011111a11101111a111101110111111111101111111001011111202a1011101122211120111022012121101111111011
11111110111221111222a0110101202211122212001011101111111110101111101111a10111111a111001110111111101111110111111110111000b0112121121021010001221121011100111110111
10110111111101210202a2201101001202211222200111111111110001101111111111a01101011a111111110111110111011110111110001011212a2201222201012212112202112221111111111111
01111101100112220222a0212212111101112222010110111111001111010110111111a11110011a111111111110111011110110110111110011112b2112211221121211111210122101101111010111
11111101011101121112b1002022000002112111211100111110111011111101111100a11111111a111111100110111111101011011111111101111a1012212120121021121212121011111001011111
01111111111112201112b1210220011212111012211011111111111111111111011011a11111111a111110111101111111111001011110011101011b2011212000112202221111102111110111110111
11101111012220001211b1021201022121212101211111101101011111111111111111a11111001a010110111111111111111010110111111111012a1101220122112212012211101211011011111011
11110111102221222210b2122211111102212210200111101111111111111111011111a01111110a110111011111111111111011011101110101101a2000201022100212212122112021101011111101
11101111001102122111b1012202011112212211010111111100110111111111110111a11101101a110011111111011111111111111010111110101b2121212121211102002012202121101111111101
11011110010202112022b2110111121212220011211111101011110111100110011111a11111010a111111111111011110110111111111011111221b1211210102111221100222111221011101110111
11111111101222122021b0011112202122011122201111111110111111011100001101a11011100a101111101111011101111111111011111010110b1021012011210012202110022221121122122111
11001111110121012122a2112102220221002010210111110111111011101001111110a11110011a110111111110101010111010111111111111221b1112211221202002020002222121200002122122
11111111012121201111b0122120012212021120011011100111101111111011101101a11001110a111110111110101101111101110111111010221a1101121000122221222001222200212011222220
10111111112121122221a1222000221011211121011011011001001111111001111110a11111110a111110011011101010111100111011100111212b1222112102110121201121212220212200111111
11111111101111010121b1211220201221012200211100111111101111010010111111a10010101a111011111111110111101111111101111110221a2202122120122222222222210221011101221001
01110110110220110010b2221210122211212221011110111111110101111111111111a11011111a110111001111110011011111110111111101221b2202002122011220210222122022221010212112
11101010112221221212b2021011220100122122111111111111101111101111111111a11111111a011100111111101101001011101110111111111b0222222112022102221222002220121111120112
10111110011122112212a2222112012221100222111111110110110101111101101111a10111110a101011111111111101111111111111111100202b0012222202102022200212201122122021022112
aaaaaaaaaaaabbbbbaaaa1002222111222210112111111111111110010101111011111a11110111a111111110111111011111110111111110111222abaabaababbbbabbaababbbbbbbbbbaaabaabbaba
1011101111101111111101100111101111111111011111101011111111110111011111a10111111a01111111010111111111011111110101101111111001111011112211220011201102100120220121
1111111111011111111011010111111010101110100111111101101111111111111111a11111111a11111010111111111111011111111011111011110111110111101120110212212012022120001010
1011100111111111111111011110111111111011111111111111011110111110011101a11111111a10111111011011111111110011100111110100111111011111121111000120122110200101221101
1101111111011011111111111110111111101011111011111111011111011110111110a11011111a11110110101101110111011111111111110111111101111111112022110120221212222211002221
0101111101111111111001011101111111110011111100110101011010111110101101a01110111a11111011011111011010101111111001101101111011111110121210111211021100111122010121
1000110011101111111100111100111111111101101111111110111111110011111111a11011111a11100011010100101010111110111101110101111100111111121112102202220112201210021011
1011111111110101011101110011110111111011111111101110110101111111101011a11111111a01111111111011111100111111011101011111110011111111121100022111212120221011202221
1101111111111101111111111111110100100001110111111111111111110111111111a11101111a11011110111111111111111110011110111101011110101111112112222222101222112102121121
1111010111111101111011011011110111111111111110111111011110111111110111a10100101a11111111111111011111111111111101111011111011111101121211111112112211022102211222
1111111110010011110111101111111111110111111011111111111101111101111101a10111111a11111111111111110111110111100111101111111001111010122121122121112102000211112112
1011111110110111111111101010111001100101111111111101101111110111111111a11110111a11101101110111101101011111111111011010101111111111001102012112221121022221121201
1101101111111101111111111111111111110110111111111110111111101110111111a11110111a10111111111001111101111111010111100010111111011111101101010211111211211121122120
1111111011111111111110111100011111111111100101111110111111011011111111a10111111a11101101111011111110110011101011111111111111111110111222122120121112221010202222
1111011011011011101111110111111111111111111110010111111111111100011111a11111111a10110011110011111111101011111111101110110101111100120022212121212000011121111122
1011110111010111101111111110110011111100101011110111111100111111011011a11101001a11111010100001111101001101111111111111011110001111121122111220222122120010012221
1011111111111111101111111111111111110110110111111111111111100110011011a11011111a01111111110111111111100111111011111111111111110110111220111101221122112012120020
0101111110101111101111101111101011111111110111011101111101101111011111a11111111a01111111110101111011111110101111111111111110111101111111121101222202211111202022
